##################
#..///.////.///..#
#.###.#.##.#.###.#
#/.///.////.///./#
#/#.#.#.##.#.#.#/#
#/.///.////.///./#
#/#.#.#.##.#.#.#/#
#/.///.////.///./#
#/#.###.##.###.#/#
#/#.###.##.###.#/#
#/.///.////.///./#
#/#.#.#.##.#.#.#/#
#/.///.////.///./#
#/#.#.#.##.#.#.#/#
#/.///.////.///./#
#.###.#.##.#.###.#
#..///.////.///..#
##################
